###################
#   s #           #
#     #           #
#     #   ####    #
#            #    #
#    #       #    #
#    ####    # f  #
#    #       #    #
###################